11111111111111111111111111111111111111111111111111111111111111111111
100000000000C0000000000000000000000000000000C000000000000000000000E1
1010010100100000101001000C0001010010010100100000101001000C0001010001
10100100101010100010010000000101001001001010101000100100000001010001
1P00000000000000000C000000C000000010010100100000101001000C0001010001
10000000000000C000000000000000000010010100100000101001000C0001010001
10000000000000000000C000000000000010010100100000101001000C0001010001
100000000000C0000000000000000000C010010100100000101001000C0001010001
1010010100100000101001000C0001010010010100100000101001000C0001010001
101001001010101000100100000001010010010100100000101001000C0001010001
1000000000000000000C000000C000000010010100100000101001000C0001010001
11111111111111111111111111111111111111111111111111111111111111111111