111111111111111
10000000000C001
100C00000000001
1101110P0011111
1E00000C0011111
111111111111111